1  1  1  1  1  1  1  1  1  1  1  1  1  1  1  1  1  1  1  1  1  1  1  1  1  1  1  1  1  1  1  1  1  1  1  1  1  1
1  3  2  2  2  2  2  2  2  2  2  2  2  2  2  2  2  2  2  2  2  2  2  2  2  2  2  2  2  2  2  2  2  2  2  2  3  1
1  2  1  1  2  1  1  1  1  1  1  1  2  1  1  1  1  1  1  2  2  1  1  1  1  1  2  1  1  1  1  1  1  2  1  1  2  1
1  2  1  1  2  1  0  0  0  0  0  1  2  1  1  1  1  1  1  2  2  1  1  1  1  1  2  1  0  0  0  0  1  2  1  1  2  1
1  2  1  1  2  1  0  0  0  0  0  1  2  2  2  2  2  2  2  2  2  2  2  2  2  2  2  1  0  0  0  0  1  2  1  1  2  1
1  2  1  1  2  1  0  0  0  0  0  1  2  1  1  1  1  1  1  2  2  1  1  1  1  1  2  1  0  0  0  0  1  2  1  1  2  1
0  2  2  2  2  1  0  0  0  0  0  1  2  1  0  0  0  0  1  2  2  1  0  0  0  1  2  1  0  0  0  0  1  2  2  2  2  0
1  2  1  1  2  1  0  0  0  0  0  1  2  1  0  0  0  0  1  2  2  1  0  0  0  1  2  1  0  0  0  0  1  2  1  1  2  1
1  2  1  1  2  1  0  0  0  0  0  1  2  1  0  0  0  0  1  2  2  1  0  0  0  1  2  1  0  0  0  0  1  2  1  1  2  1
1  2  1  1  2  1  0  0  0  0  0  1  2  1  0  0  0  0  1  2  2  1  0  0  0  1  2  1  0  0  0  0  1  2  1  1  2  1
1  2  1  1  2  1  1  1  1  1  1  1  2  1  0  0  0  0  1  2  2  1  0  0  0  1  2  1  1  1  1  1  1  2  1  1  2  1
1  2  2  2  2  2  2  2  3  2  2  2  2  1  0  0  0  0  1  2  2  1  0  0  0  1  2  2  2  2  3  2  2  2  2  2  2  1
1  2  1  1  2  1  1  1  1  1  1  1  2  1  0  0  0  0  1  2  2  1  0  0  0  1  2  1  1  1  1  1  1  2  1  1  2  1
1  2  1  1  2  1  0  0  0  0  0  1  2  1  0  0  0  0  1  2  2  1  0  0  0  1  2  1  0  0  0  0  1  2  1  1  2  1
1  2  1  1  2  1  0  0  0  0  0  1  2  1  0  0  0  0  1  2  2  1  0  0  0  1  2  1  0  0  0  0  1  2  1  1  2  1
1  2  1  1  2  1  0  0  0  0  0  1  2  1  0  0  0  0  1  2  2  1  0  0  0  1  2  1  0  0  0  0  1  2  1  1  2  1
1  2  1  1  2  1  1  1  1  1  1  1  2  1  1  1  1  1  1  2  2  1  1  1  1  1  2  1  1  1  1  1  1  2  1  1  2  1
1  2  2  2  2  2  2  2  2  2  2  2  2  2  2  2  2  2  2  2  2  2  2  2  2  2  2  2  2  2  2  2  2  2  2  2  2  1
1  2  1  1  1  1  2  1  1  1  1  1  2  1  1  1  1  1  4  4  4  1  1  1  1  1  2  1  1  1  1  2  1  1  1  1  2  1
1  2  1  0  0  1  2  1  0  0  0  1  2  1  0  0  1  5  6  7  8  0  1  0  0  1  2  1  0  0  1  2  1  0  0  1  2  1
0  2  1  0  0  1  2  1  0  0  0  1  2  1  0  0  1  0  9 10 11  0  1  0  0  1  2  1  0  0  1  2  1  0  0  1  2  0
1  2  1  0  0  1  2  1  0  0  0  1  2  1  0  0  1  1  1  1  1  1  1  0  0  1  2  1  0  0  1  2  1  0  0  1  2  1
1  2  1  0  0  1  2  1  0  0  0  1  2  1  0  0  0  0  0  0  0  0  0  0  0  1  2  1  0  0  1  2  1  0  0  1  2  1
1  2  1  0  0  1  2  1  0  0  0  1  2  1  0  0  0  0  0  0  0  0  0  0  0  1  2  1  0  0  1  2  1  0  0  1  2  1
1  2  1  1  1  1  2  1  1  1  1  1  2  1  1  1  1  1  1  1  1  1  1  1  1  1  2  1  1  1  1  2  1  1  1  1  2  1
1  2  2  2  2  2  2  2  2  2  2  2  2  2  2  2  2  2  2  2 12  2  2  2  2  2  2  2  2  2  2  2  2  2  2  2  2  1
1  2  1  1  1  1  2  1  1  1  1  1  2  1  1  1  1  1  2  1  2  1  1  1  1  1  2  1  1  1  1  2  1  1  1  1  2  1
1  2  1  0  0  1  2  1  0  0  0  1  2  1  0  0  0  1  2  1  2  1  0  0  0  1  2  1  0  0  1  2  1  0  0  1  2  1
1  2  1  0  0  1  2  1  0  0  0  1  2  1  0  0  0  1  2  1  2  1  0  0  0  1  2  1  0  0  1  2  1  0  0  1  2  1
1  2  1  0  0  1  2  1  0  0  0  1  2  1  0  0  0  1  2  1  2  1  0  0  0  1  2  1  0  0  1  2  1  0  0  1  2  1
1  2  1  0  0  1  2  1  0  0  0  1  2  1  0  0  0  1  2  1  2  1  0  0  0  1  2  1  0  0  1  2  1  0  0  1  2  1
0  2  1  0  0  1  2  1  0  0  0  1  2  1  0  0  0  1  2  1  2  1  0  0  0  1  2  1  0  0  1  2  1  0  0  1  2  0
1  2  1  0  0  1  2  1  1  1  1  1  2  1  1  1  1  1  2  1  2  1  1  1  1  1  2  1  0  0  1  2  1  0  0  1  2  1
1  2  1  0  0  1  2  2  2  3  2  2  2  2  2  2  2  2  2  1  2  2  2  2  3  2  2  1  0  0  1  2  1  0  0  1  2  1
1  2  1  0  0  1  2  1  1  1  1  1  2  1  1  1  1  1  2  1  2  1  1  1  1  1  2  1  0  0  1  2  1  0  0  1  2  1
1  2  1  0  0  1  2  1  0  0  0  1  2  1  0  0  0  1  2  1  2  1  0  0  0  1  2  1  0  0  1  2  1  0  0  1  2  1
1  2  1  1  1  1  2  1  1  1  1  1  2  1  1  1  1  1  2  1  2  1  1  1  1  1  2  1  1  1  1  2  1  1  1  1  2  1
1  3  2  2  2  2  2  2  2  2  2  2  2  2  2  2  2  2  2  2  2  2  2  2  2  2  2  2  2  2  2  2  2  2  2  2  3  1
1  1  1  1  1  1  1  1  1  1  1  1  1  1  1  1  1  1  1  1  1  1  1  1  1  1  1  1  1  1  1  1  1  1  1  1  1  1
1
