1  1  1  1  1  1  1  1  1  1  1  1  1  1  0  0  0  0  1  0  1  0  0  0  0  1  1  1  1  1  1  1  1  1  1  1  1  1
1  2  2  2  2  2  2  2  3  2  2  2  2  1  0  0  0  0  1  2  1  0  0  0  0  1  2  2  2  2  2  2  2  2  2  2  2  1
1  2  1  1  1  1  1  2  1  1  1  1  2  1  0  0  0  0  1  2  1  0  0  0  0  1  2  1  1  1  1  1  1  1  1  1  2  1
1  2  1  0  0  0  1  2  1  0  0  1  2  1  0  0  0  0  1  2  1  0  0  0  0  1  2  1  0  0  0  0  0  0  0  1  2  1
1  2  1  0  0  0  1  2  1  0  0  1  2  1  1  1  1  1  1  2  1  1  1  1  1  1  2  1  0  0  0  0  0  0  0  1  3  1
1  2  1  0  0  0  1  2  1  0  0  1  2  2  2  2  2  2  2  2  2  2  2  2  2  2  2  1  0  0  0  0  0  0  0  1  2  1
1  2  1  0  0  0  1  2  1  0  0  1  2  1  1  1  1  1  1  2  1  1  1  1  1  1  2  1  1  1  1  1  1  1  1  1  2  1
1  2  1  1  1  1  1  2  1  1  1  1  2  1  0  0  0  0  1  2  1  0  0  0  0  1  2  2  2  2  2  2  2  2  2  2  2  1
1  2  2  2  2  2  2  2  2  2  2  2  2  1  1  1  1  1  1  2  1  1  1  1  1  1  2  1  1  1  1  1  1  1  1  1  2  1
1  2  1  1  1  1  1  1  1  1  1  1  2  2  2  2  2  2  2  2  2  2  2  2  3  2  2  1  0  0  0  0  0  0  0  1  2  1
1  2  1  0  0  0  0  0  0  0  0  1  2  1  1  1  1  1  1  0  1  1  1  1  1  1  2  1  0  0  0  0  0  0  0  1  2  1
1  2  1  1  1  1  1  1  1  1  1  1  2  1  0  0  0  0  1  0  1  0  0  0  0  1  2  1  1  1  1  1  1  1  1  1  2  1
1  2  2  2  3  2  2  2  2  2  2  2  2  1  1  1  1  1  1  0  1  1  1  1  1  1  2  2  2  2  2  2  2  2  2  2  2  1
1  1  1  1  1  2  1  1  1  1  1  1  2  1  0  0  0  0  0  0  0  0  0  0  0  1  2  1  1  1  1  1  2  1  1  1  1  1
0  0  0  0  1  2  1  0  0  0  0  1  2  1  0  1  1  4  4  4  4  4  1  1  0  1  2  1  0  0  0  1  2  1  0  0  0  0
0  0  0  0  1  2  1  0  0  0  0  1  2  1  0  1  5  0  0  6  0  0  7  1  0  1  2  1  0  0  0  1  2  1  0  0  0  0
0  0  0  0  1  2  1  0  0  0  0  1  2  1  0  1  0  0  0  0  0  0  0  1  0  1  2  1  0  0  0  1  2  1  0  0  0  0
0  0  0  0  1  2  1  1  1  1  1  1  2  1  0  1  8  0  0  0  0  0  9  1  0  1  2  1  0  0  0  1  2  1  0  0  0  0
1  1  1  1  1  2  2  2  2  2  2  2  2  0  0  1  0  0  0  0  0  0  0  1  0  0  2  1  1  1  1  1  2  1  1  1  1  1
0  2  2  2  2  2  1  1  1  1  1  1  2  1  0  1  0  0  0  0  0  0  0  1  0  1  2  2  2  2  2  2  2  2  2  2  2  0
1  1  1  1  1  2  1  0  0  0  0  1  2  1  0  1 10  0  0 11  0  0 12  1  0  1  2  1  1  1  1  1  2  1  1  1  1  1
0  0  0  0  1  2  1  0  0  0  0  1  2  1  0  1  1  4  4  4  4  4  1  1  0  1  2  1  0  0  0  1  2  1  0  0  0  0
0  0  0  0  1  2  1  0  0  0  0  1  2  1  0  0  0  0  0  0  0  0  0  0  0  1  2  1  1  1  1  1  2  1  0  0  0  0
0  0  0  0  1  2  1  0  0  0  0  1  2  1  1  1  1  1  1  0  1  1  1  1  1  1  2  2  2  2  2  2  2  1  0  0  0  0
0  0  0  0  1  2  1  0  0  0  0  1  2  1  0  0  0  0  1  0  1  0  0  0  0  1  2  1  1  1  1  1  2  1  0  0  0  0
1  1  1  1  1  2  1  1  1  1  1  1  2  1  1  1  1  1  1  0  1  1  1  1  1  1  2  1  1  1  1  1  2  1  1  1  1  1
1  2  2  2  2  2  2  2  2  2  2  2  2  2  2  2  2  2  2  2  2  2  2  2  2  2  2  2  2  2  2  2  2  2  2  2  2  1
1  2  1  1  2  1  1  1  1  1  1  1  1  1  1  1  2  1  1  1  1  1  1  2  1  1  1  1  1  1  1  1  1  2  1  1  2  1
1  2  1  1  2  1  0  0  0  0  0  0  0  0  0  1  2  1  0  0  0  0  1  2  1  0  0  0  0  0  0  0  1  2  1  1  2  1
1  2  1  1  2  1  0  0  0  0  0  0  0  0  0  1  2  1  0  0  0  0  1  2  1  0  0  0  0  0  0  0  1  2  1  1  2  1
1  3  1  1  2  1  1  1  1  1  1  1  1  1  1  1  2  1  1  1  1  1  1  2  1  1  1  1  1  1  1  1  1  2  1  1  2  1
1  2  1  1  2  1  1  2  2  2  2  2  2  13 2  2  2  2  2  2  2  2  2  2  2  2  2  2 14  2  2  2  1  2  3  2  2  1
1  2  2  2  2  1  1  2  1  1  1  1  1  1  1  1  1  1  1  2  1  1  1  1  1  1  1  1  2  1  1  2  1  1  1  1  2  1
1  2  1  1  1  1  1  2  1  2  2  2  2  2  2  2  3  2  2  2  1  0  0  0  0  0  0  1  3  1  1  2  1  0  0  1  2  1
1  2  1  0  0  0  1  2  1  2  1  1  1  1  1  1  1  1  1  2  1  0  0  0  0  0  0  1  2  1  1  2  1  0  0  1  2  1
1  2  1  0  0  0  1  2  1  2  1  0  0  0  0  0  0  0  1  2  1  0  0  0  0  0  0  1  2  1  1  2  1  0  0  1  2  1
1  2  1  1  1  1  1  2  1  2  1  0  0  0  0  0  0  0  1  2  1  1  1  1  1  1  1  1  2  1  1  2  1  1  1  1  2  1
1  2  2  2  2  2  2  2  2  2  1  0  0  0  0  0  0  0  1  2  2  2  2  2  2  2  2  2  2  1  1  2  2  2  2  2  2  1
1  1  1  1  1  1  1  1  1  1  1  0  0  0  0  0  0  0  1  0  1  1  1  1  1  1  1  1  1  1  1  1  1  1  1  1  1  1
2
